6090 6090 6090 6090 6090 6090 6090 6090 6090 6090 6090 6090 6090 6090 6090 6090 6090 6090 6090 6090 6090 6090 6090 6090 6090 6090 6090 6090 6090 6090 6090 6090 6090 6090 6090 6090 6090 6090 6090 6090 6090 6090 6090 6090
6090 6090 6090 6090 6090 6090 6090 6090 6090 6090 6090 6090 6090 6090 6090 6090 6090 6090 6090 6090 6090 6090 6090 6090 6090 6090 6090 6090 6090 6090 6090 6090 6090 6090 6090 6090 6090 6090 6090 6090 6090 6090 6090 6090
6090 6090 6090 6090 6090 6090 6090 6090 6090 6090 6090 6090 6090 6090 6090 6090 6090 6090 6090 6090 6090 6090 6090 6090 6090 6090 6090 6090 6090 6090 6090 6090 6090 6090 6090 6090 6090 6090 6090 6090 6090 6090 6090 6090
6090 6090 6090 6090 6090 6090 6090 6090 6090 6090 6090 6090 6090 6090 6090 6090 6090 6090 6090 6090 6090 6090 6090 6090 6090 6090 6090 6090 6090 6090 6090 6090 6090 6090 6090 6090 6090 6090 6090 6090 6090 6090 6090 6090
6090 6090 6090 6090 6090 6090 6090 6090 6090 6090 6090 6090 6090 6090 6090 6090 6090 6090 6090 6090 6090 6090 6090 6090 6090 6090 6090 6090 6090 6090 6090 6090 6090 6090 6090 6090 6090 6090 6090 6090 6090 6090 6090 6090
6090 6090 6090 6090 6090 6090 6090 6090 6090 6090 6090 6090 6090 6090 6090 6090 6090 6090 6090 6090 6090 6090 6090 6090 6090 6090 6090 6090 6090 6090 6090 6090 6090 6090 6090 6090 6090 6090 6090 6090 6090 6090 6090 6090
6090 6090 6090 6090 6090 6090 6090 6090 6090 6090 6090 6090 6090 6090 6090 6090 6090 6090 6090 6090 6090 6090 6090 6090 6090 6090 6090 6090 6090 6090 6090 6090 6090 6090 6090 6090 6090 6090 6090 6090 6090 6090 6090 6090
6090 6090 6090 6090 6090 6090 6090 0 0 0 0 853 853 0 2602 0 853 0 0 0 0 0 0 0 0 2602 765 0 0 0 0 0 0 2602 0 847 847 6090 6090 6090 6090 6090 6090 6090
6090 6090 6090 6090 6090 6090 6090 847 0 0 0 0 0 0 0 0 0 0 0 0 0 847 0 2616 0 0 0 0 0 847 847 0 0 0 0 0 847 6090 6090 6090 6090 6090 6090 6090
6090 6090 6090 6090 6090 6090 6090 0 0 0 0 0 0 765 0 0 0 0 0 0 0 847 847 0 0 0 0 0 0 847 847 0 0 0 0 0 0 6090 6090 6090 6090 6090 6090 6090
6090 6090 6090 6090 6090 6090 6090 2602 0 0 0 765 765 0 0 0 765 765 0 0 0 847 847 0 0 0 0 0 0 0 0 0 0 0 765 765 0 6090 6090 6090 6090 6090 6090 6090
6090 6090 6090 6090 6090 6090 6090 0 0 0 0 0 0 0 0 0 0 0 0 0 0 0 0 0 0 0 0 765 0 0 0 0 0 0 0 0 0 6090 6090 6090 6090 6090 6090 6090
6090 6090 6090 6090 6090 6090 6090 0 0 0 0 0 0 0 0 0 0 0 0 0 0 0 0 0 0 0 0 0 0 0 0 0 0 0 0 0 0 6090 6090 6090 6090 6090 6090 6090
6090 6090 6090 6090 6090 6090 6090 847 847 847 847 0 0 0 0 853 853 2602 853 0 0 0 0 0 847 2602 0 0 0 0 0 847 847 847 0 0 0 6090 6090 6090 6090 6090 6090 6090
6090 6090 6090 6090 6090 6090 6090 6090 6090 6090 6090 847 0 0 0 0 853 853 847 847 0 0 0 0 847 847 0 0 0 0 0 0 0 0 0 0 0 6090 6090 6090 6090 6090 6090 6090
6090 6090 6090 6090 6090 6090 6090 0 0 0 6090 0 0 0 0 0 0 0 0 0 0 0 0 0 847 847 0 0 0 765 0 0 0 0 0 0 3 6090 6090 6090 6090 6090 6090 6090
6090 6090 6090 6090 6090 6090 6090 0 0 0 0 0 0 0 765 0 0 0 0 0 0 0 765 0 0 0 0 0 0 0 0 0 0 0 0 0 0 1163 0 0 0 0 0 0
6090 6090 6090 6090 6090 6090 6090 0 0 0 6090 0 0 0 0 0 0 0 0 0 0 0 0 847 0 0 0 0 0 0 0 853 0 0 0 0 0 1163 0 0 0 0 0 0
6090 6090 6090 6090 6090 6090 6090 6090 6090 6090 6090 847 0 0 0 0 0 853 847 847 0 0 0 765 0 0 0 0 853 853 853 853 0 0 0 0 3 6090 6090 6090 6090 6090 6090 6090
6090 6090 6090 6090 6090 6090 6090 847 847 847 847 0 0 0 0 0 853 853 853 847 0 0 0 0 0 0 0 0 0 0 2602 853 0 0 0 0 0 6090 6090 6090 6090 6090 6090 6090
6090 6090 6090 6090 6090 6090 6090 0 0 0 0 0 0 0 0 0 0 0 0 0 0 0 0 0 0 0 0 0 0 0 0 0 0 0 0 765 0 6090 6090 6090 6090 6090 6090 6090
6090 6090 6090 6090 6090 6090 6090 0 0 0 0 0 0 765 0 0 0 0 0 0 0 0 0 853 853 0 0 0 0 0 0 0 0 0 0 0 0 6090 6090 6090 6090 6090 6090 6090
6090 6090 6090 6090 6090 6090 6090 0 0 0 765 0 0 765 0 0 0 0 0 765 0 0 0 853 2602 0 0 0 0 0 0 0 0 0 0 0 0 6090 6090 6090 6090 6090 6090 6090
6090 6090 6090 6090 6090 6090 6090 0 0 0 0 0 0 0 0 0 0 0 765 765 0 0 0 0 0 0 0 0 853 0 0 0 853 853 0 0 0 6090 6090 6090 6090 6090 6090 6090
6090 6090 6090 6090 6090 6090 6090 847 0 0 0 0 0 0 0 0 0 0 0 0 0 0 0 0 0 0 0 0 853 0 0 0 853 0 0 2602 847 6090 6090 6090 6090 6090 6090 6090
6090 6090 6090 6090 6090 6090 6090 847 0 2602 0 0 853 853 0 0 0 0 0 0 0 0 0 853 2616 853 0 0 0 0 0 0 0 0 0 847 847 6090 6090 6090 6090 6090 6090 6090
6090 6090 6090 6090 6090 6090 6090 6090 6090 6090 6090 6090 6090 6090 6090 6090 6090 6090 6090 6090 6090 6090 6090 6090 6090 6090 6090 6090 6090 6090 6090 6090 6090 6090 6090 6090 6090 6090 6090 6090 6090 6090 6090 6090
6090 6090 6090 6090 6090 6090 6090 6090 6090 6090 6090 6090 6090 6090 6090 6090 6090 6090 6090 6090 6090 6090 6090 6090 6090 6090 6090 6090 6090 6090 6090 6090 6090 6090 6090 6090 6090 6090 6090 6090 6090 6090 6090 6090
6090 6090 6090 6090 6090 6090 6090 6090 6090 6090 6090 6090 6090 6090 6090 6090 6090 6090 6090 6090 6090 6090 6090 6090 6090 6090 6090 6090 6090 6090 6090 6090 6090 6090 6090 6090 6090 6090 6090 6090 6090 6090 6090 6090
6090 6090 6090 6090 6090 6090 6090 6090 6090 6090 6090 6090 6090 6090 6090 6090 6090 6090 6090 6090 6090 6090 6090 6090 6090 6090 6090 6090 6090 6090 6090 6090 6090 6090 6090 6090 6090 6090 6090 6090 6090 6090 6090 6090
6090 6090 6090 6090 6090 6090 6090 6090 6090 6090 6090 6090 6090 6090 6090 6090 6090 6090 6090 6090 6090 6090 6090 6090 6090 6090 6090 6090 6090 6090 6090 6090 6090 6090 6090 6090 6090 6090 6090 6090 6090 6090 6090 6090
6090 6090 6090 6090 6090 6090 6090 6090 6090 6090 6090 6090 6090 6090 6090 6090 6090 6090 6090 6090 6090 6090 6090 6090 6090 6090 6090 6090 6090 6090 6090 6090 6090 6090 6090 6090 6090 6090 6090 6090 6090 6090 6090 6090
6090 6090 6090 6090 6090 6090 6090 6090 6090 6090 6090 6090 6090 6090 6090 6090 6090 6090 6090 6090 6090 6090 6090 6090 6090 6090 6090 6090 6090 6090 6090 6090 6090 6090 6090 6090 6090 6090 6090 6090 6090 6090 6090 6090
 