6090 6090 6090 6090 6090 6090 6090 6090 6090 6090 6090 6090 6090 6090 6090 6090 6090 6090 6090 6090 6090 6090 6090 6090 6090 6090 6090 6090 6090 6090 6090 6090 6090 6090 6090 6090 6090 6090 6090 6090 6090 6090 6090 6090
6090 6090 6090 6090 6090 6090 6090 6090 6090 6090 6090 6090 6090 6090 6090 6090 6090 6090 6090 6090 6090 6090 6090 6090 6090 6090 6090 6090 6090 6090 6090 6090 6090 6090 6090 6090 6090 6090 6090 6090 6090 6090 6090 6090
6090 6090 6090 6090 6090 6090 6090 6090 6090 6090 6090 6090 6090 6090 6090 6090 6090 6090 6090 6090 6090 6090 6090 6090 6090 6090 6090 6090 6090 6090 6090 6090 6090 6090 6090 6090 6090 6090 6090 6090 6090 6090 6090 6090
6090 6090 6090 6090 6090 6090 6090 6090 6090 6090 6090 6090 6090 6090 6090 6090 6090 6090 6090 6090 6090 6090 6090 6090 6090 6090 6090 6090 6090 6090 6090 6090 6090 6090 6090 6090 6090 6090 6090 6090 6090 6090 6090 6090
6090 6090 6090 6090 6090 6090 6090 6090 6090 6090 6090 6090 6090 6090 6090 6090 6090 6090 6090 6090 6090 6090 6090 6090 6090 6090 6090 6090 6090 6090 6090 6090 6090 6090 6090 6090 6090 6090 6090 6090 6090 6090 6090 6090
6090 6090 6090 6090 6090 6090 6090 6090 6090 6090 6090 6090 6090 6090 6090 6090 6090 6090 6090 6090 6090 6090 6090 6090 6090 6090 6090 6090 6090 6090 6090 6090 6090 6090 6090 6090 6090 6090 6090 6090 6090 6090 6090 6090
6090 6090 6090 6090 6090 6090 6090 6090 6090 6090 6090 6090 6090 6090 6090 6090 6090 6090 6090 6090 6090 6090 6090 6090 6090 6090 6090 6090 6090 6090 6090 6090 6090 6090 6090 6090 6090 6090 6090 6090 6090 6090 6090 6090
6090 6090 6090 6090 6090 6090 6090 0 0 0 0 853 853 0 0 0 853 0 0 0 0 0 0 0 0 0 765 0 0 0 0 0 0 0 0 847 847 6090 6090 6090 6090 6090 6090 6090
6090 6090 6090 6090 6090 6090 6090 847 0 0 0 0 0 0 0 0 0 0 0 0 0 847 0 0 0 0 0 0 0 847 847 0 0 0 0 0 847 6090 6090 6090 6090 6090 6090 6090
6090 6090 6090 6090 6090 6090 6090 0 0 0 0 0 0 765 0 0 0 0 0 0 0 847 847 0 0 0 0 0 0 847 847 0 0 0 0 0 0 6090 6090 6090 6090 6090 6090 6090
6090 6090 6090 6090 6090 6090 6090 0 0 0 0 765 765 0 0 0 765 765 0 0 0 847 847 0 0 0 0 0 0 0 0 0 0 0 765 765 0 6090 6090 6090 6090 6090 6090 6090
6090 6090 6090 6090 6090 6090 6090 0 0 0 0 0 0 0 0 0 0 0 0 0 0 0 0 0 0 0 0 765 0 0 0 0 0 0 0 0 0 6090 6090 6090 6090 6090 6090 6090
6090 6090 6090 6090 6090 6090 6090 0 0 0 0 0 0 0 0 0 0 0 0 0 0 0 0 0 0 0 0 0 0 0 0 0 0 0 0 0 0 6090 6090 6090 6090 6090 6090 6090
6090 6090 6090 6090 6090 6090 6090 847 847 847 847 0 0 0 0 853 853 0 853 0 0 0 0 0 847 0 0 0 0 0 0 847 847 847 0 0 0 6090 6090 6090 6090 6090 6090 6090
6090 6090 6090 6090 6090 6090 6090 6090 6090 6090 6090 847 0 0 0 0 853 853 847 847 0 0 0 0 847 847 0 0 0 0 0 0 0 0 0 0 0 6090 6090 6090 6090 6090 6090 6090
6090 6090 6090 6090 6090 6090 6090 0 0 0 6090 0 0 0 0 0 0 0 0 0 0 0 0 0 847 847 0 0 0 765 0 0 0 0 0 0 3 6090 6090 6090 6090 6090 6090 6090
6090 6090 6090 6090 6090 6090 6090 0 0 0 0 0 0 0 765 0 0 0 0 0 0 0 765 0 0 0 0 0 0 0 0 0 0 0 0 0 0 0 1163 0 0 0 0 0
6090 6090 6090 6090 6090 6090 6090 0 0 0 6090 0 0 0 0 0 0 0 0 0 0 0 0 847 0 0 0 0 0 0 0 853 0 0 0 0 0 0 1163 0 0 0 0 0
6090 6090 6090 6090 6090 6090 6090 6090 6090 6090 6090 847 0 0 0 0 0 853 847 847 0 0 0 765 0 0 0 0 853 853 853 853 0 0 0 0 3 6090 6090 6090 6090 6090 6090 6090
6090 6090 6090 6090 6090 6090 6090 847 847 847 847 0 0 0 0 0 853 853 853 847 0 0 0 0 0 0 0 0 0 0 0 853 0 0 0 0 0 6090 6090 6090 6090 6090 6090 6090
6090 6090 6090 6090 6090 6090 6090 0 0 0 0 0 0 0 0 0 0 0 0 0 0 0 0 0 0 0 0 0 0 0 0 0 0 0 0 765 0 6090 6090 6090 6090 6090 6090 6090
6090 6090 6090 6090 6090 6090 6090 0 0 0 0 0 0 765 0 0 0 0 0 0 0 0 0 853 853 0 0 0 0 0 0 0 0 0 0 0 0 6090 6090 6090 6090 6090 6090 6090
6090 6090 6090 6090 6090 6090 6090 0 0 0 765 0 0 765 0 0 0 0 0 765 0 0 0 853 0 0 0 0 0 0 0 0 0 0 0 0 0 6090 6090 6090 6090 6090 6090 6090
6090 6090 6090 6090 6090 6090 6090 0 0 0 0 0 0 0 0 0 0 0 765 765 0 0 0 0 0 0 0 0 853 0 0 0 853 853 0 0 0 6090 6090 6090 6090 6090 6090 6090
6090 6090 6090 6090 6090 6090 6090 847 0 0 0 0 0 0 0 0 0 0 0 0 0 0 0 0 0 0 0 0 853 0 0 0 853 0 0 0 847 6090 6090 6090 6090 6090 6090 6090
6090 6090 6090 6090 6090 6090 6090 847 0 0 0 0 853 853 0 0 0 0 0 0 0 0 0 853 0 853 0 0 0 0 0 0 0 0 0 847 847 6090 6090 6090 6090 6090 6090 6090
6090 6090 6090 6090 6090 6090 6090 6090 6090 6090 6090 6090 6090 6090 6090 6090 6090 6090 6090 6090 6090 6090 6090 6090 6090 6090 6090 6090 6090 6090 6090 6090 6090 6090 6090 6090 6090 6090 6090 6090 6090 6090 6090 6090
6090 6090 6090 6090 6090 6090 6090 6090 6090 6090 6090 6090 6090 6090 6090 6090 6090 6090 6090 6090 6090 6090 6090 6090 6090 6090 6090 6090 6090 6090 6090 6090 6090 6090 6090 6090 6090 6090 6090 6090 6090 6090 6090 6090
6090 6090 6090 6090 6090 6090 6090 6090 6090 6090 6090 6090 6090 6090 6090 6090 6090 6090 6090 6090 6090 6090 6090 6090 6090 6090 6090 6090 6090 6090 6090 6090 6090 6090 6090 6090 6090 6090 6090 6090 6090 6090 6090 6090
6090 6090 6090 6090 6090 6090 6090 6090 6090 6090 6090 6090 6090 6090 6090 6090 6090 6090 6090 6090 6090 6090 6090 6090 6090 6090 6090 6090 6090 6090 6090 6090 6090 6090 6090 6090 6090 6090 6090 6090 6090 6090 6090 6090
6090 6090 6090 6090 6090 6090 6090 6090 6090 6090 6090 6090 6090 6090 6090 6090 6090 6090 6090 6090 6090 6090 6090 6090 6090 6090 6090 6090 6090 6090 6090 6090 6090 6090 6090 6090 6090 6090 6090 6090 6090 6090 6090 6090
6090 6090 6090 6090 6090 6090 6090 6090 6090 6090 6090 6090 6090 6090 6090 6090 6090 6090 6090 6090 6090 6090 6090 6090 6090 6090 6090 6090 6090 6090 6090 6090 6090 6090 6090 6090 6090 6090 6090 6090 6090 6090 6090 6090
6090 6090 6090 6090 6090 6090 6090 6090 6090 6090 6090 6090 6090 6090 6090 6090 6090 6090 6090 6090 6090 6090 6090 6090 6090 6090 6090 6090 6090 6090 6090 6090 6090 6090 6090 6090 6090 6090 6090 6090 6090 6090 6090 6090
 