 6090  6090  6090  6090  6090  6090  6090  6090  6090  6090  6090  6090  6090  6090  6090  6090  6090  6090  6090  6090  6090  6090  6090  6090  6090  6090  6090  6090  6090  6090  6090  6090  6090  6090  6090  6090  6090  6090  6090  6090  6090  6090  6090  6090  6090  6090  6090  6090  6090  6090  6090  6090  6090  6090 
 6090  6090  6090  6090  6090  6090  6090  6090  6090  6090  6090  6090  6090  6090  6090  6090  6090  6090  6090  6090  6090  6090  6090  6090  6090  6090  6090  6090  6090  6090  6090  6090  6090  6090  6090  6090  6090  6090  6090  6090  6090  6090  6090  6090  6090  6090  6090  6090  6090  6090  6090  6090  6090  6090 
 6090  6090  6090  6090  6090  6090  6090  6090  6090  6090  6090  6090  6090  6090  6090  6090  6090  6090  6090  6090  6090  6090  6090  6090  6090  6090  6090  6090  6090  6090  6090  6090  6090  6090  6090  6090  6090  6090  6090  6090  6090  6090  6090  6090  6090  6090  6090  6090  6090  6090  6090  6090  6090  6090 
 6090  6090  6090  6090  6090  6090  6090  6090  6090  6090  6090  6090  6090  6090  6090  6090  6090  6090  6090  6090  6090  6090  6090  6090  6090  6090  6090  6090  6090  6090  6090  6090  6090  6090  6090  6090  6090  6090  6090  6090  6090  6090  6090  6090  6090  6090  6090  6090  6090  6090  6090  6090  6090  6090 
 6090  6090  6090  6090  6090  6090  6090  6090  6090  6090  6090  6090  6090  6090  6090  6090  6090  6090  6090  6090  6090  6090  6090  6090  6090  6090  6090  6090  6090  6090  6090  6090  6090  6090  6090  6090  6090  6090  6090  6090  6090  6090  6090  6090  6090  6090  6090  6090  6090  6090  6090  6090  6090  6090 
 6090  6090  6090  6090  6090  6090  6090  6090  6090  6090  6090  6090  6090  6090  6090  6090  6090  6090  6090  6090  6090  6090  6090  6090  6090  6090  6090  6090  6090  6090  6090  6090  6090  6090  6090  6090  6090  6090  6090  6090  6090  6090  6090  6090  6090  6090  6090  6090  6090  6090  6090  6090  6090  6090 
 6090  6090  6090  6090  6090  6090  6090  6090  6090  6090  6090  6090  6090  6090  6090  6090  6090  6090  6090  6090  6090  6090  6090  6090  6090  6090  6090  6090  6090  6090  6090  6090  6090  6090  6090  6090  6090  6090  6090  6090  6090  6090  6090  6090  6090  6090  6090  6090  6090  6090  6090  6090  6090  6090 
 6090  6090  6090  6090  6090  6090  6090  2602 0 0 0 0 0 409 409 0 0 0 0 409 409 409 0 0 0 0 0 0 409 0 0  2616 0 0 409 0 0 0 409  2602 0 0 0 0 0 0  2602  6090  6090  6090  6090  6090  6090  6090 
 6090  6090  6090  6090  6090  6090  6090 0 72 0 0 0 0 0 0 0 0 0 0 0 0 409  2602 0 0 0 0 0 409 0 0 0 0 409 409 0 0 0 409 0 0 0 0 72 0 0 0  6090  6090  6090  6090  6090  6090  6090 
 6090  6090  6090  6090  6090  6090  6090 0 0 0 0 409 0 0 0 0 0 0 0 0 0 0 0 0 0 409 0 0 0 0 0 0 0 0 0 0 0 0 409 409 409 0 0 0 0 0 0  6090  6090  6090  6090  6090  6090  6090 
 6090  6090  6090  6090  6090  6090  6090 0 0 0 0 409 409 409 409 409 0 0 0 72 0 0 0 0 0 409 409 409 0 0 0 0 0 0 0 0 0 0 0 0 409 0 0 0 409 409 409  6090  6090  6090  6090  6090  6090  6090 
 6090  6090  6090  6090  6090  6090  6090 0 0 0 0 0 0 0 0 0 0 0 0 0 0 0 0 0 0 0 0 0 0 0 0 0 0 0 0 0 72 0 0 0 409 0 0 0 0 0 0  6090  6090  6090  6090  6090  6090  6090 
 6090  6090  6090  6090  6090  6090  6090 0 0 0 72 0 0 0 0 0 0 0 0 0 0 409 0 0 0 0 72 0 0 0 409 409 409 0 0 0 0 0 0 0 409 0 0 0 0 0 0  6090  6090  6090  6090  6090  6090  6090 
 6090  6090  6090  6090  6090  6090  6090 0 0 0 0 0 0 409 0 0 0 0 0 0 0 409 0 0 0 0 0 0 0 0 409  2602 0 0 0 0 0 0 0 0 0 0 0 0 72 0  2602  6090  6090  6090  6090  6090  6090  6090 
 6090  6090  6090  6090  6090  6090  6090 0 0 0 0 0 0 409 409 409 409 409 0 0 0 409 409 409 409 409 409 409 409 409 409 0 0 0 0 0 0 0 0 0 0 0 0 0 0 0 3 6090  6090  6090  6090  6090  6090  6090
0 0 0 0 0 0 3 0 0 0 0 72 0 409 0  2602 0 0 0 0 0 0 0 0 0 409 409 409 409 409 0 0 0 0 0 0 409 409 0 0 0 0 409 0 0 0 0 1163 0 0 0 0 0 0
0 0 0 0 0 0 3 0 0 0 0 72 0 409 409 0 0 0 0 0 0 0 0 0  2602 409 409 409 409 409 0 0 0 0 0 0 409 409 0 0 0 0 409 0 0 0 0 1163 0 0 0 0 0 0
 6090  6090  6090  6090  6090  6090  6090 0 0 0 0 0 0 0 0 0 0 0 0 409 409 409 409 409 409 409 409 409 409 409 0 0 72 0 0 0 0 0 0 0 0 0 0 0 0 0 3  6090  6090  6090  6090  6090  6090  6090
 6090  6090  6090  6090  6090  6090  6090 0 0 0 0 0 0 0 0 0 0 0 409 409 409  2602 0 0 409 0 0 0 0 0 0 0 0 0 0 0 0 0 0 0 0 0 0 0 0 0 0  6090  6090  6090  6090  6090  6090  6090 
 6090  6090  6090  6090  6090  6090  6090 0 0 0 0 0 0 0 409 0 0 409 409 0 0 0 0 0 409  2602 0 0 72 0 0 0 0 0 409 0 0 0 0 409 409 0 0 0 0 72 0  6090  6090  6090  6090  6090  6090  6090 
 6090  6090  6090  6090  6090  6090  6090 72 0 0 0 409 409 409 409 0 0 0 0 0 0 0 0 0 409 0 0 0 0 0 0 0 0 0 409 0 0 0 0 0 409  2602 0 0 0 0 0  6090  6090  6090  6090  6090  6090  6090 
 6090  6090  6090  6090  6090  6090  6090 0 0 0 0 409 409 409 409 0 0 0 0 0 0 0 0 0 409 409 409 0 0 0 0  2616 0 0 0 0 0 0 0 0 409 409 409 409 0 0 0  6090  6090  6090  6090  6090  6090  6090 
 6090  6090  6090  6090  6090  6090  6090 0 0 0 0 0 0 0 0 0 0 0 0 0 0 0 0 0 0 0 0 0 0 0 409 0 0 0 0 0 0 0 0 0 0 0 409 409 409 0 0  6090  6090  6090  6090  6090  6090  6090 
 6090  6090  6090  6090  6090  6090  6090 0 72 0 0 0 0 0 0 0 0 0 409 409 0 0 0 0 0 0 0 0 0 0 409 409 409 409 409 0 0 0 0 0 0 0 0 0 0 0 0  6090  6090  6090  6090  6090  6090  6090 
 6090  6090  6090  6090  6090  6090  6090 0 0 0 0 0 0 0 0 0 0 0 409  2602 0 0 72 0 0 409 409 0 0 0 0 0 0 0 0 0 0 0 72 0 0 0 0 0 0 0 0  6090  6090  6090  6090  6090  6090  6090 
 6090  6090  6090  6090  6090  6090  6090  2602 0 0 409 409 409 0 0 0 0 0 409 0 0 0 0 0 0 0 0 0 0 0 0 0 0 0 0 0 0 0 0 0 0 0 0 0  2602 0 72  6090  6090  6090  6090  6090  6090  6090 
 6090  6090  6090  6090  6090  6090  6090  6090  6090  6090  6090  6090  6090  6090  6090  6090  6090  6090  6090  6090  6090  6090  6090  6090  6090  6090  6090  6090  6090  6090  6090  6090  6090  6090  6090  6090  6090  6090  6090  6090  6090  6090  6090  6090  6090  6090  6090  6090  6090  6090  6090  6090  6090  6090 
 6090  6090  6090  6090  6090  6090  6090  6090  6090  6090  6090  6090  6090  6090  6090  6090  6090  6090  6090  6090  6090  6090  6090  6090  6090  6090  6090  6090  6090  6090  6090  6090  6090  6090  6090  6090  6090  6090  6090  6090  6090  6090  6090  6090  6090  6090  6090  6090  6090  6090  6090  6090  6090  6090 
 6090  6090  6090  6090  6090  6090  6090  6090  6090  6090  6090  6090  6090  6090  6090  6090  6090  6090  6090  6090  6090  6090  6090  6090  6090  6090  6090  6090  6090  6090  6090  6090  6090  6090  6090  6090  6090  6090  6090  6090  6090  6090  6090  6090  6090  6090  6090  6090  6090  6090  6090  6090  6090  6090 
 6090  6090  6090  6090  6090  6090  6090  6090  6090  6090  6090  6090  6090  6090  6090  6090  6090  6090  6090  6090  6090  6090  6090  6090  6090  6090  6090  6090  6090  6090  6090  6090  6090  6090  6090  6090  6090  6090  6090  6090  6090  6090  6090  6090  6090  6090  6090  6090  6090  6090  6090  6090  6090  6090 
 6090  6090  6090  6090  6090  6090  6090  6090  6090  6090  6090  6090  6090  6090  6090  6090  6090  6090  6090  6090  6090  6090  6090  6090  6090  6090  6090  6090  6090  6090  6090  6090  6090  6090  6090  6090  6090  6090  6090  6090  6090  6090  6090  6090  6090  6090  6090  6090  6090  6090  6090  6090  6090  6090 
 6090  6090  6090  6090  6090  6090  6090  6090  6090  6090  6090  6090  6090  6090  6090  6090  6090  6090  6090  6090  6090  6090  6090  6090  6090  6090  6090  6090  6090  6090  6090  6090  6090  6090  6090  6090  6090  6090  6090  6090  6090  6090  6090  6090  6090  6090  6090  6090  6090  6090  6090  6090  6090  6090 
 6090  6090  6090  6090  6090  6090  6090  6090  6090  6090  6090  6090  6090  6090  6090  6090  6090  6090  6090  6090  6090  6090  6090  6090  6090  6090  6090  6090  6090  6090  6090  6090  6090  6090  6090  6090  6090  6090  6090  6090  6090  6090  6090  6090  6090  6090  6090  6090  6090  6090  6090  6090  6090  6090
