 6090  6090  6090  6090  6090  6090  6090  6090  6090  6090  6090  6090  6090  6090  6090  6090  6090  6090  6090  6090  6090  6090  6090  6090  6090  6090  6090  6090  6090  6090  6090  6090  6090  6090  6090  6090  6090  6090  6090  6090  6090  6090  6090  6090  6090  6090  6090  6090  6090  6090  6090  6090  6090  6090  6090  6090  6090  6090  6090  6090  6090  6090  6090  6090 
 6090  6090  6090  6090  6090  6090  6090  6090  6090  6090  6090  6090  6090  6090  6090  6090  6090  6090  6090  6090  6090  6090  6090  6090  6090  6090  6090  6090  6090  6090  6090  6090  6090  6090  6090  6090  6090  6090  6090  6090  6090  6090  6090  6090  6090  6090  6090  6090  6090  6090  6090  6090  6090  6090  6090  6090  6090  6090  6090  6090  6090  6090  6090  6090 
 6090  6090  6090  6090  6090  6090  6090  6090  6090  6090  6090  6090  6090  6090  6090  6090  6090  6090  6090  6090  6090  6090  6090  6090  6090  6090  6090  6090  6090  6090  6090  6090  6090  6090  6090  6090  6090  6090  6090  6090  6090  6090  6090  6090  6090  6090  6090  6090  6090  6090  6090  6090  6090  6090  6090  6090  6090  6090  6090  6090  6090  6090  6090  6090 
 6090  6090  6090  6090  6090  6090  6090  6090  6090  6090  6090  6090  6090  6090  6090  6090  6090  6090  6090  6090  6090  6090  6090  6090  6090  6090  6090  6090  6090  6090  6090  6090  6090  6090  6090  6090  6090  6090  6090  6090  6090  6090  6090  6090  6090  6090  6090  6090  6090  6090  6090  6090  6090  6090  6090  6090  6090  6090  6090  6090  6090  6090  6090  6090 
 6090  6090  6090  6090  6090  6090  6090  6090  6090  6090  6090  6090  6090  6090  6090  6090  6090  6090  6090  6090  6090  6090  6090  6090  6090  6090  6090  6090  6090  6090  6090  6090  6090  6090  6090  6090  6090  6090  6090  6090  6090  6090  6090  6090  6090  6090  6090  6090  6090  6090  6090  6090  6090  6090  6090  6090  6090  6090  6090  6090  6090  6090  6090  6090 
 6090  6090  6090  6090  6090  6090  6090  6090  6090  6090  6090  6090  6090  6090  6090  6090  6090  6090  6090  6090  6090  6090  6090  6090  6090  6090  6090  6090  6090  6090  6090  6090  6090  6090  6090  6090  6090  6090  6090  6090  6090  6090  6090  6090  6090  6090  6090  6090  6090  6090  6090  6090  6090  6090  6090  6090  6090  6090  6090  6090  6090  6090  6090  6090 
 6090  6090  6090  6090  6090  6090  6090  6090  6090  6090  6090  6090  6090  6090  6090  6090  6090  6090  6090  6090  6090  6090  6090  6090  6090  6090  6090  6090  6090  6090  6090  6090  6090  6090  6090  6090  6090  6090  6090  6090  6090  6090  6090  6090  6090  6090  6090  6090  6090  6090  6090  6090  6090  6090  6090  6090  6090  6090  6090  6090  6090  6090  6090  6090 
 6090  6090  6090  6090  6090  6090  6090 0 0 0 0 0 0 0 0 0 0 0 0 0 0 0 6405 0 0 0 0 0 0 0 0 0 0 0 0 0 0 0 0 0 0 0 0 0 0 0 0 0 0 0 0 0 0 0 0 0 0  6090  6090  6090  6090  6090  6090  6090
 6090  6090  6090  6090  6090  6090  6090 0 0 0 6405 0 0 1442 0 0 0 6405 0 0 0 0 0 0 0 2602 1442 0 0 6405 0 0 1442 1442 0 0 0 0 0 0 6405 0 0 2616 0 6405 0 0 0 0 6405 0 0 0 0 0 0  6090  6090  6090  6090  6090  6090  6090 
 6090  6090  6090  6090  6090  6090  6090 2602 0 0 0 0 0 1442 0 0 0 0 0 0 0 0 0 0 0 0 0 0 0 0 0 0 0 1442 0 0 0 1442 0 0 0 0 1442 1442 1442 1442 0 0 0 6405 0 0 0 1442 0 0 6405  6090  6090  6090  6090  6090  6090  6090 
 6090  6090  6090  6090  6090  6090  6090 0 1442 1442 0 0 0 1442 0 0 0 0 0 1442 1442 1442 1442 0 0 0 0 0 0 0 0 0 0 0 0 0 0 1442 0 0 0 0 1442 0 0 0 0 0 0 0 0 0 2602 1442 0 0 6405  6090  6090  6090  6090  6090  6090  6090 
 6090  6090  6090  6090  6090  6090  6090 0 0 0 0 0 0 0 0 0 6405 0 0 0 0 0 0 0 0 6405 0 0 1442 1442 2602 0 0 0 6405 0 0 0 0 0 0 0 0 0 0 6405 0 0 0 0 0 0 1442 1442 0 0 0  6090  6090  6090  6090  6090  6090  6090 
 6090  6090  6090  6090  6090  6090  6090 0 0 0 6405 0 0 0 0 0 0 6405 0 0 1442 1442 0 0 0 0 0 0 0 1442 1442 0 0 0 6405 0 0 0 0 0 0 0 0 0 0 0 0 0 0 0 0 0 1442 1442 0 0 0  6090  6090  6090  6090  6090  6090  6090 
 6090  6090  6090  6090  6090  6090  6090 0 0 0 0 0 1442 1442 0 0 0 0 0 0 2602 1442 0 0 0 0 0 0 0 0 1442 0 0 0 0 0 2602 1442 0 0 0 1442 1442 0 0 0 0 1442 0 0 6405 0 0 0 0 0 6405  6090  6090  6090  6090  6090  6090  6090 
 6090  6090  6090  6090  6090  6090  6090 0 0 0 0 0 0 1442 0 0 1442 0 0 0 0 0 0 0 1442 0 0 0 0 0 0 0 0 0 0 1442 1442 1442 0 0 0 0 0 0 0 0 2602 1442 0 0 6405 0 0 0 0 0  3  6090  6090  6090  6090  6090  6090  6090 
0 0 0 0 0 0  3 0 0 0 0 0 0 0 0 0 1442 1442 1442 1442 0 0 0 0 1442 0 0 6405 0 0 0 0 0 0 0 0 0 0 0 0 0 0 0 0 0 0 1442 1442 0 0 0 0 0 6405 0 0 0 0  6090  6090  6090  6090  6090  6090 
0 0 0 0 0 0  3 0 0 0 0 0 0 0 0 0 0 0 0 0 0 0 0 0 1442 2602 0 0 0 0 0 0 0 0 0 0 0 6405 0 0 0 1442 0 0 0 0 0 0 0 0 0 0 0 6405 0 0 0 6107  6090  6090  6090  6090  6090  6090 
 6090  6090  6090  6090  6090  6090  6090 0 0 0 0 0 0 6405 6405 0 0 0 0 0 0 6405 0 0 1442 1442 0 0 0 1442 1442 1442 0 0 0 0 0 0 6405 0 2602 1442 0 0 0 0 0 0 0 0 0 0 0 0 0 0 0 0  6090  6090  6090  6090  6090  6090 
 6090  6090  6090  6090  6090  6090  6090 0 0 0 0 0 0 0 0 0 0 0 0 6405 0 0 0 0 1442 1442 0 0 0 0 0 0 0 0 1442 0 0 0 0 0 0 1442 0 0 0 6405 0 0 0 0 1442 2602 0 0 0 0  3  6090  6090  6090  6090  6090  6090  6090 
 6090  6090  6090  6090  6090  6090  6090 0 0 0 0 0 0 0 0 0 0 0 0 0 0 0 0 0 0 0 0 0 0 0 0 0 0 0 1442 0 0 0 0 0 0 1442 0 0 0 6405 0 0 1442 1442 1442 1442 0 0 0 0 0  6090  6090  6090  6090  6090  6090  6090 
 6090  6090  6090  6090  6090  6090  6090 0 1442 1442 1442 0 0 0 1442 1442 0 0 0 0 1442 0 0 0 6405 0 0 0 0 0 0 1442 1442 2602 1442 0 0 0 0 0 0 0 0 0 0 0 0 0 0 0 0 0 0 0 0 6405 0  6090  6090  6090  6090  6090  6090  6090 
 6090  6090  6090  6090  6090  6090  6090 0 0 0 0 0 0 1442 1442 1442 0 0 0 1442 1442 0 0 0 0 0 0 0 0 0 0 1442 1442 1442 1442 0 0 0 6405 0 0 0 0 0 0 0 0 0 0 0 0 0 0 0 0 0 0  6090  6090  6090  6090  6090  6090  6090 
 6090  6090  6090  6090  6090  6090  6090 0 0 0 0 0 0 0 1442 2602 0 0 0 1442 1442 0 0 0 0 0 1442 0 0 0 0 0 0 0 0 0 0 0 0 0 0 0 2602 1442 0 0 0 0 0 1442 0 2602 1442 0 0 0 0  6090  6090  6090  6090  6090  6090  6090 
 6090  6090  6090  6090  6090  6090  6090 0 0 0 0 6405 0 0 0 0 0 0 0 0 0 0 0 6405 0 0 1442 0 0 0 1442 0 0 0 0 0 0 0 0 1442 1442 1442 1442 1442 6405 0 0 0 0 1442 1442 1442 1442 0 0 0 0  6090  6090  6090  6090  6090  6090  6090 
 6090  6090  6090  6090  6090  6090  6090 0 0 0 6405 6405 0 0 0 0 0 0 0 0 0 0 0 6405 0 0 2602 0 0 0 0 0 0 0 6405 0 6405 0 0 0 0 0 0 2616 0 0 6405 0 0 0 0 0 0 0 0 6405 0  6090  6090  6090  6090  6090  6090  6090 
 6090  6090  6090  6090  6090  6090  6090 2602 0 0 0 0 0 0 0 0 0 0 0 0 0 0 0 0 0 0 0 0 0 0 0 0 0 0 0 0 0 0 0 0 0 0 0 0 0 0 0 0 0 0 0 0 0 0 0 0 2602  6090  6090  6090  6090  6090  6090  6090 
 6090  6090  6090  6090  6090  6090  6090  6090  6090  6090  6090  6090  6090  6090  6090  6090  6090  6090  6090  6090  6090  6090  6090  6090  6090  6090  6090  6090  6090  6090  6090  6090  6090  6090  6090  6090  6090  6090  6090  6090  6090  6090  6090  6090  6090  6090  6090  6090  6090  6090  6090  6090  6090  6090  6090  6090  6090  6090  6090  6090  6090  6090  6090  6090 
 6090  6090  6090  6090  6090  6090  6090  6090  6090  6090  6090  6090  6090  6090  6090  6090  6090  6090  6090  6090  6090  6090  6090  6090  6090  6090  6090  6090  6090  6090  6090  6090  6090  6090  6090  6090  6090  6090  6090  6090  6090  6090  6090  6090  6090  6090  6090  6090  6090  6090  6090  6090  6090  6090  6090  6090  6090  6090  6090  6090  6090  6090  6090  6090 
 6090  6090  6090  6090  6090  6090  6090  6090  6090  6090  6090  6090  6090  6090  6090  6090  6090  6090  6090  6090  6090  6090  6090  6090  6090  6090  6090  6090  6090  6090  6090  6090  6090  6090  6090  6090  6090  6090  6090  6090  6090  6090  6090  6090  6090  6090  6090  6090  6090  6090  6090  6090  6090  6090  6090  6090  6090  6090  6090  6090  6090  6090  6090  6090 
 6090  6090  6090  6090  6090  6090  6090  6090  6090  6090  6090  6090  6090  6090  6090  6090  6090  6090  6090  6090  6090  6090  6090  6090  6090  6090  6090  6090  6090  6090  6090  6090  6090  6090  6090  6090  6090  6090  6090  6090  6090  6090  6090  6090  6090  6090  6090  6090  6090  6090  6090  6090  6090  6090  6090  6090  6090  6090  6090  6090  6090  6090  6090  6090 
 6090  6090  6090  6090  6090  6090  6090  6090  6090  6090  6090  6090  6090  6090  6090  6090  6090  6090  6090  6090  6090  6090  6090  6090  6090  6090  6090  6090  6090  6090  6090  6090  6090  6090  6090  6090  6090  6090  6090  6090  6090  6090  6090  6090  6090  6090  6090  6090  6090  6090  6090  6090  6090  6090  6090  6090  6090  6090  6090  6090  6090  6090  6090  6090 
 6090  6090  6090  6090  6090  6090  6090  6090  6090  6090  6090  6090  6090  6090  6090  6090  6090  6090  6090  6090  6090  6090  6090  6090  6090  6090  6090  6090  6090  6090  6090  6090  6090  6090  6090  6090  6090  6090  6090  6090  6090  6090  6090  6090  6090  6090  6090  6090  6090  6090  6090  6090  6090  6090  6090  6090  6090  6090  6090  6090  6090  6090  6090  6090 
 6090  6090  6090  6090  6090  6090  6090  6090  6090  6090  6090  6090  6090  6090  6090  6090  6090  6090  6090  6090  6090  6090  6090  6090  6090  6090  6090  6090  6090  6090  6090  6090  6090  6090  6090  6090  6090  6090  6090  6090  6090  6090  6090  6090  6090  6090  6090  6090  6090  6090  6090  6090  6090  6090  6090  6090  6090  6090  6090  6090  6090  6090  6090  6090